PPL = "countries/Papal States.txt"
OTY = "countries/OttoYem.txt"
RYM = "countries/YemenRep.txt"
BYI = "countries/BritishYem.txt"
MSC = "countries/Muscat.txt"
TRU = "countries/Trucials.txt"
RSH = "countries/Rashid.txt"
NEJ = "countries/Nejd.txt"
JOH = "countries/Johore.txt"
TER = "countries/Terengganu.txt"
KEL = "countries/Kelantan.txt"
KED = "countries/Kedah.txt"
FMS = "countries/MalayFed.txt"
BOE = "countries/Boers.txt"
CTO = "countries/Cape.txt"
ZUL = "countries/Zulu.txt"
NAM = "countries/Namibia.txt"
PCH = "countries/Pancho.txt"
AOZ = "countries/USMexico.txt"
MMJ = "countries/Mijikenda.txt"
RKE = "countries/KeniaRep.txt"
KES = "countries/KeniaState.txt"
KPC = "countries/Kalenjin.txt"
UGA = "countries/Uganda.txt"
VCC = "countries/VictoriaCom.txt"
MRO = "countries/Morocco.txt"
LBR = "countries/Liberia.txt"
ARB = "countries/Saudis.txt"
HEJ = "countries/Hejaz.txt"
HAS = "countries/Hashemites.txt"
BUR = "countries/Burma.txt"
AZA = "countries/AzadHind.txt"
OTO = "countries/Ottomans.txt"
AMN = "countries/Armenia.txt"
ABJ = "countries/Azerbaijan.txt"
MRC = "countries/MountainRep.txt"
ALA = "countries/Alaska.txt"
FRI = "countries/Friuli.txt"
CRT = "countries/Croatia.txt"
ORE = "countries/Orenburg.txt"
AKH = "countries/Arkhangelsk.txt"
MAG = "countries/Magadan.txt"
EUR = "countries/EurasianHorde.txt"
SIB = "countries/Siberia.txt"
MIR = "countries/Mirny.txt"
HSR = "countries/HungarianSocRep.txt"
DPF = "countries/DirectoireFrance.txt"
RGD = "countries/GermanRep.txt"
AZS = "countries/SwissZone.txt"
CZC = "countries/CzechRep.txt"
PLN = "countries/PolishRep.txt"
SLE = "countries/SilesiaMand.txt"
DAN = "countries/DanzigCity.txt"
TBU = "countries/Bulgaria.txt"
CHL = "countries/Chile.txt"
BLV = "countries/Bolivia.txt"
AGN = "countries/Argentina.txt"
UKG = "countries/UnitedKingdom.txt"
IRP = "countries/IrishRep.txt"
NET = "countries/Netherlands.txt"
KHV = "countries/Khiva.txt"
BKH = "countries/Bukhara.txt"
ETU = "countries/EastTurkestan.txt"
KSP = "countries/Spain.txt"
TIB = "countries/Tibet.txt"
LTP = "countries/LeagueThreeProvinces.txt"
SAH = "countries/Sahara.txt"
RIK = "countries/RightKuom.txt"
LIK = "countries/LeftKuom.txt"
SCH = "countries/SichuanClique.txt"
YUA = "countries/YunnanCli.txt"
CHN = "countries/ChineseRepublic.txt"
MNG = "countries/MongolianKhanate.txt"
MAU = "countries/ManchukuoS.txt"
SHA = "countries/ShandongClique.txt"
JAE = "countries/JapaneseEmpire.txt"
AMU = "countries/AmurProtectorate.txt"
SVE = "countries/SocialistVietnam.txt"
KVE = "countries/KingdomVietnam.txt"
RVE = "countries/RepublicVietnam.txt"
BZJ = "countries/BelarusianState.txt"
LTH = "countries/LithuanianState.txt"
COU = "countries/Courland.txt"
LVL = "countries/Livland.txt"
EEQ = "countries/Estonia.txt"
GAH = "countries/Galicia.txt"
RSA = "countries/Russia.txt"
UFT = "countries/UkrainianFreeTer.txt"
CLB = "countries/Colombia.txt"
KSW = "countries/Sweden.txt"
KEG = "countries/Egypt.txt"
KPE = "countries/Persia.txt"
GSR = "countries/GeorgianSovietRep.txt"
KRO = "countries/Romania.txt"
KIT = "countries/Italy.txt"
AUC = "countries/AustralianCommonwealth.txt"
RPA = "countries/Pakistan.txt"
KCS = "countries/Kuban.txt"
KNY = "countries/Norway.txt"
IFS = "countries/IndianFedState.txt"
BDS = "countries/Bangladesh.txt"
KZA = "countries/Kazakhstan.txt"
KNP = "countries/Nepal.txt"
KBH = "countries/Bhutan.txt"
MEG = "countries/MexicanGov.txt"
CRR = "countries/Carrancistas.txt"
DNM = "countries/Denmark.txt"
PRT = "countries/Portugal.txt"
ALN = "countries/Albania.txt"
SRB = "countries/Serbia.txt"
GRC = "countries/Greece.txt"
FLN = "countries/Finland.txt"
KSI = "countries/KingdomSiam.txt"
AGH = "countries/Afghanistan.txt"
FRC = "countries/Congo.txt"
CYR = "countries/Cyrenaica.txt"
LYB = "countries/Libya.txt"
NOA = "countries/NorthernAnarchy.txt"
UNS = "countries/UnitedStates.txt"
CND = "countries/Canada.txt"
GMQ = "countries/Guatemala.txt"
HNQ = "countries/Honduras.txt"
ESH = "countries/Salvador.txt"
RNI = "countries/Nicaragua.txt"
CSR = "countries/Costarica.txt"
PAT = "countries/Patagonia.txt"
BZL = "countries/Brazil.txt"
VNZ = "countries/Venezuela.txt"
SNK = "countries/Sudan.txt"
KOE = "countries/Ethiopia.txt"
PPP = "countries/Papua.txt"
PGY = "countries/Paraguay.txt"
UGY = "countries/Uruguay.txt"
SMY = "countries/Samoa.txt"
ECD = "countries/Ecuador.txt"
PEU = "countries/Peru.txt"
HII = "countries/Haiti.txt"
DRP = "countries/Domrep.txt"
CBA = "countries/Cuba.txt"
QBC = "countries/Quebec.txt"
PAA = "countries/Panama.txt"
PHP = "countries/Philippines.txt"

####RELEASABLES######
AUR = "countries/Austria.txt"
EPR = "countries/EastPrussia.txt"
PMM = "countries/Pommerania.txt"
BVI = "countries/Bavaria.txt"
BDB = "countries/Baden.txt"
WMM = "countries/WÃ¼rttemberg.txt"
CUK = "countries/Capart.txt"
KMI = "countries/Komi.txt


#NOTE: Useful to add a basic default loc entry for each tag in 00_countries.txt so that hovering over a tag will show the tag's name in loc (ie. PAP: "Papal States")
#NOTE 2: Please, always make sure that the tag is not repeating. Happened to me once and almost destroyed the mod
